alias chrome="open -a 'Google Chrome'"
alias s="subl"
alias gs="git status"
alias ga="git add"
alias gc="git commit -m"
alias gcl="git clone"
alias gpom="git push origin master"
alias gpl="git pull"
alias glsf="git ls-files"
alias bi="bundle install"
alias dds="find . -name ".DS_Store" -delete"
alias cl="clear"
alias rc="rails console"
alias rcs="rails console --sandbox"
alias rgmi="rails generate migration"
alias rmi="rails db:migrate"
alias rmis="rails db:migrate:status"
alias rgmo="rails generate model"
alias rseed="rails db:seed"
#alias rnew="rails new -d postgresql --skip-turbolinks --skip-webpack-install --skip-javascript"
alias rnew="rails new -d postgresql"
alias rdbc="rails db:create"
alias rgc="rails generate controller"
alias rserv="rails server"
alias rr="rails routes"
alias rre="rails routes --expanded"
alias rgs="rails generate scaffold"
alias rgma="rails generate mailer"
alias hc="heroku create"
alias hdbm="heroku run rails db:migrate"
alias gph="git push heroku HEAD:master"
alias rservprod="RAILS_ENV=production RAILS_SERVE_STATIC_FILES=true rails server"
alias rasspre="rails assets:precompile"
alias rasscl="rails assets:clean"
alias rassclo="rails assets:clobber"
alias gccw="gcc -Wall -Werror -Wextra"
# alias norm="~/.norminette/norminette.rb"
alias norm="norminette"